000000000000040000000111000000
000000000000000000000111000000
000000000000000000000111000000
000000000000000000000111000000
000000000000000000000111000000
000000000000000000000111000000
000000000000000000000111000000
000000000000000000000111000000
000000000000000000001111000000
000000000000000000001111000000
000000000000000000000111000000
000000000000000000000111000000
000000000000000000000111000000
000000000000000000000111000000
000000000000000000000111000000
000000000000000000000111000000
000000000000000000000111000000
000000000000000000002111000000
000000000000000000000111000000
000000000000000000000111000000
000000000000000000000111000000
000000000000000000000111000000
000000000000000000001111000000
000000000000000000001111000000
000000000000000000001111000000
000000000000000000000111000000
000000000000000000000111000000
000000000000000000000111000000
000000000000000000011111000000
000000000000000000011111000000
000000000000000000011111000000
000000000000000000000000000000
000000000000000000000000000000
000000000000000000011111000000
000000000000000000011111000000
000000000000000000011111000000
000000000000000000000111000000
000000000000000000000111000000
000000000000000000000111000000
000000000000000000000111000000
000000000000000000011111000000
000000000000000000011111000000
000000000000000000011111000000
000000000000000000000111000000
000000000000000000000111000000
000000000000000000000111000000
000000000000000000000101000000
000000000000000000000101000000
000000000000000000000001000000
000000000000000000000001000000
000000000000000000000101000000
000000000000000000000101000000
000000000000000000000101000000
000000000000000000000101000000
000000000000000000001111000000
000000000000000000001111000000
000000000000000000000111000000
000000000000000000002111000000
000000000000000000000111000000
000000000000000000000111000000
000000000000000000000111000000
000000000000000000001111000000
000000000000000000001111000000
000000000000000000011111000000
000000000000000000111111000000
000000000000000001111111000000
000000000000000001111111000000
000000000000000000000000000000
000000000000000000000000000000
000000000000000001111111000000
000000000000000001111111000000
000000000000000000111111000000
000000000000000000011111000000
000000000000000000001111000000
000000000000000000000111000000
000000000000000000000111000000
000000000000000000002111000000
000000000000000000000111000000
000000000000000000000111000000
000000000000000000000111000000
000000000000000000001111000000
000000000000000000001111000000
000000000000000000000111000000
000000000000000000000111000000
000000000000000000000000000000
000000000000000000000000000000
000000000000000000000111000000
000000000000000000000111000000
000000000000000000000111000000
000000000000000000000111000000
000000000000000000000111000000
000000000000000000000111000000
000000000000000000011111000000
000000000000000000011111000000
000000000000000000000111000000
000000000000000000000111000000
000000000000000000000111000000
000000000000000000000111000000
000000000000000000000111000000
000000000000000000003111000000
