000000000000000400001100000000
000000000000000000001100000000
000000000000000000011100000000
000000000000000000011000000000
000000000000000000111000000000
000000000000000000110000000000
000000000000000001110000000000
000000000000000001100000000000
000000000000000011100000000000
000000000000000011100000000000
000000000000000001100000000000
000000000000000001110000000000
000000000000000000110000000000
000000000000000000111000000000
000000000000000000011000000000
000000000000000000011100000000
000000000000000000001100000000
000000000000000000001110000000
000000000000000000000110000000
000000000000000000000111000000
000000000000000000000011000000
000000000000000000000211000000
000000000000000000000011000000
000000000000000000000111000000
000000000000000000000111000000
000000000000000000000011000000
000000000000000000000011000000
000000000000000000000211000000
000000000000000000000011000000
000000000000000000000111000000
000000000000000000000110000000
000000000000000000001110000000
000000000000000000001100000000
000000000000000000011100000000
000000000000000000011000000000
000000000000000000111000000000
000000000000000000110000000000
000000000000000001110000000000
000000000000000001110000000000
000000000000000000110000000000
000000000000000000110000000000
000000000000000002110000000000
000000000000000000110000000000
000000000000000000110000000000
000000000000000001110000000000
000000000000000001110000000000
000000000000000000110000000000
000000000000000000110000000000
000000000000000002110000000000
000000000000000000110000000000
000000000000000001110000000000
000000000000000001110000000000
000000000000000000110000000000
000000000000000000110000000000
000000000000000002110000000000
000000000000000000110000000000
000000000000000001110000000000
000000000000000001110000000000
000000000000000000110000000000
000000000000000000111000000000
000000000000000000011000000000
000000000000000000011100000000
000000000000000000021100000000
000000000000000000001110000000
000000000000000000000110000000
000000000000000000000111000000
000000000000000000000011000000
000000000000000000000011100000
000000000000000000000001100000
000000000000000000000001110000
000000000000000000000000110000
000000000000000000000000111000
000000000000000000000000011000
000000000000000000000000011000
000000000000000000000000011000
000000000000000000000000011000
000000000000000000000000211000
000000000000000000000000011000
000000000000000000010000011000
000000000000000000111000011000
000000000000000001111100011000
000000000000000011111111111000
000000000000000001111100011000
000000000000000000111000011000
000000000000000000010000011000
000000000000000000000000011000
000000000000000000000000011000
000000000000000000000000011000
000000000000000000000000011000
000000000000000000000000011000
000000000000000000000000211000
000000000000000000000000011000
000000000000000000000000011000
000000000000000000000000111000
000000000000000000000000111000
000000000000000000000000011000
000000000000000000000000011000
000000000000000000000000011000
000000000000000000000000011000
000000000000000000000000311000
