000000000000400000000111000000
000000000000000000000111000000
000000000000000000000111000000
000000000000000000000111000000
000000000000000000011111000000
000000000000000000011111000000
000000000000000000011111000000
000000000000000000011111000000
000000000000000000000111000000
000000000000000000000111000000
000000000000000010000111000000
000000000000000111000111000000
000000000000001111111111000000
000000000000000111000111000000
000000000000000010000111000000
000000000000000000000111000000
000000000000000000000111000000
000000000000000000002111000000
000000000000000000000111000000
000000000000000000000111000000
000000000000000000000111000000
000000000000000000000111000000
000000000000000000001111000000
000000000000000000001111000000
000000000000000000001111000000
000000000000000000000000000000
000000000000000000000000000000
000000000000000000000000000000
000000000000000000011111000000
000000000000000000011111000000
000000000000000000011111000000
000000000000000000011111000000
000000000000000000000111000000
000000000000000000002111000000
000000000000000000000111000000
000000000000000000000111000000
000000000000000000000111000000
000000000000000000000111000000
000000000000000000000111000000
000000000000000000000111000000
000000000000000000001111000000
000000000000000000001111000000
000000000000000000000000000000
000000000000000000001111000000
000000000000000000001111000000
000000000000000000000111000000
000000000000000000000111000000
000000000000000000000111000000
000000000000000000000111000000
000000000000000000000111000000
000000000000000000000111000000
000000000000000000000111000000
000000000000000000000111000000
000000000000000000000111000000
000000000000000000001111000000
000000000000000000001111000000
000000000000000000000111000000
000000000000000000002111000000
000000000000000000000111000000
000000000000000000000111000000
000000000000000000000111000000
000000000000000001000111000000
000000000000000011100111000000
000000000000000111111111000000
000000000000000011100111000000
000000000000000001000111000000
000000000000000000000111000000
000000000000000000000000000000
000000000000000000000000000000
000000000000000001111111000000
000000000000000001111111000000
000000000000000000111111000000
000000000000000000011111000000
000000000000000000000111000000
000000000000000000000111000000
000000000000000000000111000000
000000000000000000002111000000
000000000000000000000111000000
000000000000000000000111000000
000000000000000000000111000000
000000000000000000000111000000
000000000000000000000111000000
000000000000000000000111000000
000000000000000000001111000000
000000000000000000000000000000
000000000000000000000000000000
000000000000000000001111000000
000000000000000000000111000000
000000000000000000000111000000
000000000000000000000111000000
000000000000000000000111000000
000000000000000000002111000000
000000000000000000000111000000
000000000000000000000111000000
000000000000000000000111000000
000000000000000000000111000000
000000000000000000000111000000
000000000000000000000111000000
000000000000000000000111000000
000000000000000000003111000000
