000000000000004000011110000000
000000000000000000011110000000
000000000000000000001110000000
000000000000000000001110000000
000000000000000000001110000000
000000000000000000021110000000
000000000000000000001110000000
000000000000000000001110000000
000000000000000000001110000000
000000000000000000001110000000
000000000000000000011110000000
000000000000000000011110000000
000000000000000000000000000000
000000000000000000000000000000
000000000000000000011110000000
000000000000000000011110000000
000000000000000000001110000000
000000000000000000001110000000
000000000000000000001110000000
000000000000000000021110000000
000000000000000000001110000000
000000000000000000001110000000
000000000000000000001110000000
000000000000000000001110000000
000000000000000000011110000000
000000000000000000011110000000
000000000000000000000000000000
000000000000000000000000000000
000000000000000000011110000000
000000000000000000011110000000
000000000000000000001110000000
000000000000000000001110000000
000000000000000000001110000000
000000000000000000021110000000
000000000000000000001110000000
000000000000000000001110000000
000000000000000000001110000000
000000000000000000001110000000
000000000000000000011110000000
000000000000000000011110000000
000000000000000000000000000000
000000000000000000000000000000
000000000000000000011110000000
000000000000000000011110000000
000000000000000000001110000000
000000000000000000001110000000
000000000000000000001110000000
000000000000000000021110000000
000000000000000000001110000000
000000000000000000021110000000
000000000000000000001110000000
000000000000000000001110000000
000000000000000000011110000000
000000000000000000011110000000
000000000000000000000000000000
000000000000000000000000000000
000000000000000000000000000000
000000000000000000011110000000
000000000000000000011110000000
000000000000000000001110000000
000000000000000000001110000000
000000000000000000021110000000
000000000000000000001110000000
000000000000000000021110000000
000000000000000000001110000000
000000000000000000001110000000
000000000000000000011110000000
000000000000000000011110000000
000000000000000000000000000000
000000000000000000000000000000
000000000000000000000000000000
000000000000000000000000000000
000000000000000000011110000000
000000000000000000011110000000
000000000000000000001110000000
000000000000000000001110000000
000000000000000000021110000000
000000000000000000001110000000
000000000000000000021110000000
000000000000000000001110000000
000000000000000000001110000000
000000000000000000001110000000
000000000000000000011110000000
000000000000000000011110000000
000000000000000000000000000000
000000000000000000000000000000
000000000000000000000000000000
000000000000000000000000000000
000000000000000000000000000000
000000000000000000011110000000
000000000000000000011110000000
000000000000000000001110000000
000000000000000000001110000000
000000000000000000021110000000
000000000000000000001110000000
000000000000000000021110000000
000000000000000000001110000000
000000000000000000001110000000
000000000000000000011110000000
000000000000000000311110000000
